1111111111111111111111111111111111111111
1111111111111111111111111111111111111111
1111111111111111111111111111111111111111
1111111111111111111111111111111111111111
1111222222222222222222222222222222221111
1111222222222222222222222222222222221111
1111222222333333333333333333322222221111
1111222222333333333333333333322222221111
1111222222333333333333333333322222221111
1111222222333334444444433333322222221111
1111222222333334444444433333322222221111
1111222222333334444444433333322222221111
1111222222333334444444433333322222221111
1111222222333334444444433333322222221111
1111222222333335555555533333322222221111
1111222222333335555555533333322222221111
1111222222333335555555533333322222221111
1111222222333335555555533333322222221111
1111222222333335555555533333322222221111
1111111111111113333333311111111111111111
1111111111111113333333311111111111111111
1111111111111113333333311111111111111111
1111111111111112222222211111111111111111
1111111111111112222222211111111111111111
1111111111111112222222211111111111111111
1111111111111111111111111111111111111111
1111111111111111111111111111111111111111
1111111111111111111111111111111111111111
1111111111111000000000001111111111111111
1111111111111000000000001111111111111111
1111111111111000000000001111111111111111
1111111111111000000000001111111111111111
1111111111123000000000003211111111111111
1111111111123444444444443211111111111111
1111111111123000000000003211111111111111
1111111111111000000000001111111111111111
1111111111111000000000001111111111111111
1111111111111000000000001111111111111111
1111111111111111111111111111111111111111
1111111111111111111111111111111111111111